instancia,semente_1,semente_2,score_construtivo, tempo_construtivo,score_genetic,time_genetic,score_sa,time_sa,total_time
SET1 1-2/64-45-1-2,2324334358,1702240393,588,814,0,0,624,2269,3083
SET1 1-2/64-45-1-2,3307280374,1702240399,618,800,0,0,654,1898,2698
SET1 1-2/64-45-1-2,3904807722,1702240403,594,808,0,0,624,2251,3059
SET1 1-2/64-45-1-2,570515330,1702240409,600,820,0,0,654,2073,2893
SET1 1-2/64-45-1-2,1364270902,1702240414,618,805,0,0,654,1890,2695
SET1 1-2/64-45-1-2,1968818711,1702240419,618,815,0,0,624,2379,3194
SET1 1-2/64-45-1-2,3065410147,1702240424,564,806,0,0,654,1880,2686
SET1 1-2/64-45-1-2,3652710241,1702240429,618,816,0,0,624,2289,3105
SET1 1-2/64-45-1-2,360562092,1702240434,612,797,0,0,624,2341,3138
SET1 1-2/64-45-1-2,1401180059,1702240440,630,920,0,0,798,2934,3854
SET1 1-2/100-35-1-2,3155645964,1702240446,241,477,0,0,241,941,1418
SET1 1-2/100-35-1-2,2745178419,1702240450,241,481,0,0,241,921,1402
SET1 1-2/100-35-1-2,2315980667,1702240453,241,483,0,0,241,952,1435
SET1 1-2/100-35-1-2,1925576053,1702240457,227,484,0,0,241,945,1429
SET1 1-2/100-35-1-2,1524338758,1702240461,241,478,0,0,241,947,1425
SET1 1-2/100-35-1-2,1122137189,1702240465,227,482,0,0,241,896,1378
SET1 1-2/100-35-1-2,671124034,1702240469,241,476,0,0,241,911,1387
SET1 1-2/100-35-1-2,226495171,1702240473,241,480,0,0,241,924,1404
SET1 1-2/100-35-1-2,4095857990,1702240477,241,484,0,0,241,880,1364
SET1 1-2/100-35-1-2,3630658922,1702240481,241,478,0,0,241,908,1386
SET1 2-3/66-125-2-3,3193478723,1702240484,1290,1920,0,0,1435,2866,4786
SET1 2-3/66-125-2-3,1616019109,1702240491,1270,1926,0,0,1575,3023,4949
SET1 2-3/66-125-2-3,205225404,1702240499,1265,1944,0,0,1580,3329,5273
SET1 2-3/66-125-2-3,3405128812,1702240506,1330,1949,0,0,1610,2706,4655
SET1 2-3/66-125-2-3,1694445899,1702240513,1230,1958,0,0,1530,2378,4336
SET1 2-3/66-125-2-3,3958886165,1702240519,1245,1906,0,0,1550,2050,3956
SET1 2-3/66-125-2-3,1548751197,1702240526,1310,1935,0,0,1585,1995,3930
SET1 2-3/66-125-2-3,3412475819,1702240532,1320,1909,0,0,1565,2497,4406
SET1 2-3/66-125-2-3,1455054740,1702240538,1275,1940,0,0,1525,4894,6834
SET1 2-3/66-125-2-3,1924235376,1702240548,1230,1949,0,0,1535,2761,4710
SET1 2-3/102-60-2-3,271464700,1702240554,137,191,0,0,137,548,739
SET1 2-3/102-60-2-3,3517459845,1702240558,71,119,0,0,71,12,131
SET1 2-3/102-60-2-3,1872634393,1702240560,71,119,0,0,71,444,563
SET1 2-3/102-60-2-3,649742292,1702240563,71,119,0,0,71,12,131
SET1 2-3/102-60-2-3,3296264957,1702240566,155,253,0,0,165,222,475
SET1 2-3/102-60-2-3,1988705011,1702240569,148,257,0,0,148,121,378
SET1 2-3/102-60-2-3,600905239,1702240572,71,119,0,0,71,13,132
SET1 2-3/102-60-2-3,3248498894,1702240575,71,120,0,0,71,13,133
SET1 2-3/102-60-2-3,1596229779,1702240577,137,192,0,0,137,520,712
SET1 2-3/102-60-2-3,529971916,1702240580,243,391,0,0,243,682,1073
SET1 3-4/64-70-3-4,4120758297,1702240584,852,937,0,0,918,2181,3118
SET1 3-4/64-70-3-4,864309406,1702240589,924,1091,0,0,1068,2719,3810
SET1 3-4/64-70-3-4,2588984127,1702240595,852,1006,0,0,1002,2580,3586
SET1 3-4/64-70-3-4,4093786541,1702240601,942,1050,0,0,1032,2395,3445
SET1 3-4/64-70-3-4,1154923772,1702240607,990,1090,0,0,1110,3176,4266
SET1 3-4/64-70-3-4,3333450434,1702240613,864,1071,0,0,1002,2455,3526
SET1 3-4/64-70-3-4,483199454,1702240619,924,1084,0,0,1044,3836,4920
SET1 3-4/64-70-3-4,3323054051,1702240626,828,1002,0,0,906,2512,3514
SET1 3-4/64-70-3-4,464694533,1702240632,834,972,0,0,930,3624,4596
SET1 3-4/64-70-3-4,2978059329,1702240639,942,1056,0,0,1068,2792,3848
SET1 3-4/100-40-3-4,450367357,1702240645,299,525,0,0,299,1107,1632
SET1 3-4/100-40-3-4,273899885,1702240649,299,523,0,0,299,1124,1647
SET1 3-4/100-40-3-4,111580736,1702240653,299,534,0,0,299,1057,1591
SET1 3-4/100-40-3-4,4184319967,1702240657,299,528,0,0,299,1140,1668
SET1 3-4/100-40-3-4,4039423731,1702240661,299,527,0,0,299,1198,1725
SET1 3-4/100-40-3-4,3957943323,1702240666,299,525,0,0,299,1098,1623
SET1 3-4/100-40-3-4,3772911837,1702240670,299,530,0,0,299,1178,1708
SET1 3-4/100-40-3-4,3668517486,1702240674,299,527,0,0,299,1275,1802
SET1 3-4/100-40-3-4,3657507984,1702240678,299,524,0,0,299,1168,1692
SET1 3-4/100-40-3-4,3532766602,1702240682,299,532,0,0,299,1088,1620
SET2 5-3/66-60-5-3,3341172978,1702240686,590,663,0,0,655,2483,3146
SET2 5-3/66-60-5-3,4132799511,1702240691,575,650,0,0,600,2242,2892
SET2 5-3/66-60-5-3,317421883,1702240696,765,709,0,0,850,3415,4124
SET2 5-3/66-60-5-3,2030648215,1702240702,580,668,0,0,590,2223,2891
SET2 5-3/66-60-5-3,2512721877,1702240707,595,715,0,0,620,2623,3338
SET2 5-3/66-60-5-3,3438683889,1702240712,620,657,0,0,680,2426,3083
SET2 5-3/66-60-5-3,4115420920,1702240717,555,668,0,0,605,1630,2298
SET2 5-3/66-60-5-3,4003455444,1702240721,650,641,0,0,665,1839,2480
SET2 5-3/66-60-5-3,4081199503,1702240726,635,668,0,0,730,3687,4355
SET2 5-3/66-60-5-3,1728135986,1702240732,775,706,0,0,830,2594,3300
SET2 5-3/100-45-5-3,2615584045,1702240737,272,484,0,0,272,800,1284
SET2 5-3/100-45-5-3,2101605194,1702240741,367,673,0,0,367,1492,2165
SET2 5-3/100-45-5-3,2474649304,1702240746,272,487,0,0,272,803,1290
SET2 5-3/100-45-5-3,1962237903,1702240749,272,490,0,0,272,806,1296
SET2 5-3/100-45-5-3,1459153571,1702240753,272,479,0,0,272,792,1271
SET2 5-3/100-45-5-3,928025118,1702240757,367,672,0,0,367,1368,2040
SET2 5-3/100-45-5-3,1169684525,1702240762,272,478,0,0,272,802,1280
SET2 5-3/100-45-5-3,651845636,1702240765,367,677,0,0,367,1619,2296
SET2 5-3/100-45-5-3,1157869447,1702240770,272,478,0,0,272,801,1279
SET2 5-3/100-45-5-3,639048875,1702240774,367,674,0,0,367,2049,2723
SET2 6-4/66-50-6-4,1562866115,1702240779,535,472,0,0,540,1422,1894
SET2 6-4/66-50-6-4,1413899318,1702240783,455,490,0,0,455,1389,1879
SET2 6-4/66-50-6-4,1249566470,1702240787,415,430,0,0,435,1274,1704
SET2 6-4/66-50-6-4,909409389,1702240791,400,405,0,0,410,937,1342
SET2 6-4/66-50-6-4,206968026,1702240795,510,407,0,0,510,978,1385
SET2 6-4/66-50-6-4,3845270439,1702240799,490,457,0,0,510,1402,1859
SET2 6-4/66-50-6-4,3664988722,1702240803,605,492,0,0,610,1377,1869
SET2 6-4/66-50-6-4,3493540923,1702240807,505,520,0,0,505,1247,1767
SET2 6-4/66-50-6-4,3220623649,1702240811,455,447,0,0,490,1481,1928
SET2 6-4/66-50-6-4,3109192645,1702240815,500,461,0,0,510,1044,1505
SET2 6-4/100-35-6-4,2571059101,1702240819,241,481,0,0,241,757,1238
SET2 6-4/100-35-6-4,2014527011,1702240822,241,477,0,0,241,875,1352
SET2 6-4/100-35-6-4,1575857687,1702240826,241,481,0,0,241,864,1345
SET2 6-4/100-35-6-4,1127966741,1702240830,241,480,0,0,241,842,1322
SET2 6-4/100-35-6-4,658476891,1702240834,241,478,0,0,241,841,1319
SET2 6-4/100-35-6-4,184550185,1702240838,241,476,0,0,241,758,1234
SET2 6-4/100-35-6-4,3934539600,1702240842,241,477,0,0,241,901,1378
SET2 6-4/100-35-6-4,3523824809,1702240845,241,481,0,0,241,846,1327
SET2 6-4/100-35-6-4,3056027159,1702240849,241,480,0,0,241,894,1374
SET2 6-4/100-35-6-4,2637514457,1702240853,241,482,0,0,241,787,1269
SET3 10-4/66-125-10-4,2113707316,1702240857,1230,1537,0,0,1495,2919,4456
SET3 10-4/66-125-10-4,268120724,1702240864,1255,1563,0,0,1460,2816,4379
SET3 10-4/66-125-10-4,2647030316,1702240870,1280,1513,0,0,1605,1956,3469
SET3 10-4/66-125-10-4,4111259519,1702240876,1260,1510,0,0,1560,2026,3536
SET3 10-4/66-125-10-4,1346902149,1702240882,1245,1534,0,0,1500,2330,3864
SET3 10-4/66-125-10-4,3203530976,1702240888,1355,1531,0,0,1600,2058,3589
SET3 10-4/66-125-10-4,495448992,1702240894,1355,1531,0,0,1580,2022,3553
SET3 10-4/66-125-10-4,2046235174,1702240900,1335,1535,0,0,1650,1698,3233
SET3 10-4/66-125-10-4,3273155648,1702240905,1235,1438,0,0,1500,2535,3973
SET3 10-4/66-125-10-4,945677868,1702240912,1275,1568,0,0,1550,1909,3477
SET3 10-4/100-200-10-4,2418508668,1702240917,880,2964,0,0,1061,10376,13340
SET3 10-4/100-200-10-4,1115802975,1702240933,880,2952,0,0,1071,10333,13285
SET3 10-4/100-200-10-4,4045411084,1702240949,874,2965,0,0,1053,8935,11900
SET3 10-4/100-200-10-4,1297910080,1702240963,882,2901,0,0,1101,18069,20970
SET3 10-4/100-200-10-4,3324934593,1702240987,898,3053,0,0,1132,27921,30974
SET3 10-4/100-200-10-4,2471701311,1702241021,805,2755,0,0,1030,13798,16553
SET3 10-4/100-200-10-4,80965781,1702241040,827,2881,0,0,1002,10748,13629
SET3 10-4/100-200-10-4,3358715498,1702241056,849,2895,0,0,1013,15607,18502
SET3 10-4/100-200-10-4,2915864278,1702241077,882,2863,0,0,1089,29868,32731
SET3 10-4/100-200-10-4,3822433229,1702241112,743,2676,0,0,876,10308,12984
SET3 12-5/64-75-12-5,2153501832,1702241128,942,959,0,0,1062,2193,3152
SET3 12-5/64-75-12-5,3315912932,1702241133,960,1001,0,0,1104,5489,6490
SET3 12-5/64-75-12-5,3524547627,1702241142,900,968,0,0,996,2569,3537
SET3 12-5/64-75-12-5,776124332,1702241148,972,975,0,0,1140,5010,5985
SET3 12-5/64-75-12-5,476019854,1702241156,1026,1025,0,0,1164,3904,4929
SET3 12-5/64-75-12-5,3416542703,1702241163,960,1013,0,0,1104,5119,6132
SET3 12-5/64-75-12-5,3264016836,1702241172,1032,1035,0,0,1140,2666,3701
SET3 12-5/64-75-12-5,680627663,1702241178,870,931,0,0,948,2561,3492
SET3 12-5/64-75-12-5,2185597513,1702241183,846,919,0,0,924,2541,3460
SET3 12-5/64-75-12-5,3661846465,1702241189,978,1019,0,0,1062,4111,5130
SET3 12-5/100-180-12-5,2508829664,1702241197,790,2247,0,0,930,10043,12290
SET3 12-5/100-180-12-5,197008616,1702241212,775,2117,0,0,885,10303,12420
SET3 12-5/100-180-12-5,2314712661,1702241227,857,2446,0,0,952,12269,14715
SET3 12-5/100-180-12-5,2430315436,1702241244,917,2390,0,0,994,11899,14289
SET3 12-5/100-180-12-5,2121011059,1702241261,787,2261,0,0,943,13196,15457
SET3 12-5/100-180-12-5,2978124100,1702241279,823,2326,0,0,948,9611,11937
SET3 12-5/100-180-12-5,313086974,1702241293,775,2237,0,0,879,9906,12143
SET3 12-5/100-180-12-5,2151251745,1702241308,841,2461,0,0,1009,10977,13438
SET3 12-5/100-180-12-5,991495654,1702241324,704,2157,0,0,861,9306,11463
SET3 12-5/100-180-12-5,2158065829,1702241338,817,2403,0,0,970,13093,15496
SET4/100-20-3-3,3055523914,1702241356,166,369,0,0,166,352,721
SET4/100-20-3-3,1520631968,1702241359,215,501,0,0,215,1341,1842
SET4/100-20-3-3,1079211697,1702241363,215,499,0,0,215,1538,2037
SET4/100-20-3-3,822073178,1702241367,99,255,0,0,99,112,367
SET4/100-20-3-3,3189301532,1702241369,277,514,0,0,277,993,1507
SET4/100-20-3-3,2404830506,1702241373,300,578,0,0,300,1480,2058
SET4/100-20-3-3,2171897985,1702241377,331,672,0,0,353,2488,3160
SET4/100-20-3-3,3039491247,1702241382,340,673,0,0,354,2310,2983
SET4/100-20-3-3,3731629748,1702241387,249,720,0,0,249,2351,3071
SET4/100-20-3-3,212097401,1702241392,336,749,0,0,357,2281,3030
SET4/100-25-3-3,949560629,1702241397,268,834,0,0,274,2169,3003
SET4/100-25-3-3,1672281527,1702241402,458,1142,0,0,518,5662,6804
SET4/100-25-3-3,1890226096,1702241411,388,854,0,0,390,2916,3770
SET4/100-25-3-3,3370705005,1702241417,205,446,0,0,205,1079,1525
SET4/100-25-3-3,2606939941,1702241420,294,755,0,0,313,3604,4359
SET4/100-25-3-3,374881811,1702241426,321,686,0,0,323,4221,4907
SET4/100-25-3-3,2990964727,1702241433,334,867,0,0,336,2866,3733
SET4/100-25-3-3,135853085,1702241439,279,547,0,0,279,1646,2193
SET4/100-25-3-3,38679103,1702241443,329,862,0,0,349,2813,3675
SET4/100-25-3-3,1421619738,1702241449,305,735,0,0,308,3803,4538
SET4/102-35-3-3,3670246469,1702241455,276,573,0,0,276,926,1499
SET4/102-35-3-3,3393750167,1702241460,276,566,0,0,276,957,1523
SET4/102-35-3-3,3144225928,1702241464,277,567,0,0,277,927,1494
SET4/102-35-3-3,2863601002,1702241468,277,568,0,0,277,980,1548
SET4/102-35-3-3,2640748337,1702241472,149,364,0,0,149,465,829
SET4/102-35-3-3,1696078983,1702241475,312,642,0,0,312,2009,2651
SET4/102-35-3-3,2574311780,1702241480,196,377,0,0,196,879,1256
SET4/102-35-3-3,2054823370,1702241484,115,314,0,0,115,142,456
SET4/102-35-3-3,738463599,1702241487,194,376,0,0,197,873,1249
SET4/102-35-3-3,211656529,1702241491,196,375,0,0,196,899,1274
SET4/102-40-3-3,2402181162,1702242025,196,505,0,0,196,970,1475
SET4/102-40-3-3,2106406564,1702242029,369,767,0,0,369,2267,3034
SET4/102-40-3-3,3374283898,1702242035,185,528,0,0,185,351,879
SET4/102-40-3-3,2479912608,1702242038,196,488,0,0,196,637,1125
SET4/102-40-3-3,1829120635,1702242042,273,563,0,0,273,1245,1808
SET4/102-40-3-3,1868830731,1702242046,374,860,0,0,383,2330,3190
SET4/102-40-3-3,3284644359,1702242052,185,526,0,0,185,361,887
SET4/102-40-3-3,2393151620,1702242056,185,524,0,0,185,357,881
SET4/102-40-3-3,1496903325,1702242059,271,553,0,0,271,1274,1827
SET4/102-40-3-3,1549566766,1702242063,196,493,0,0,196,968,1461
SET4/102-45-3-3,1245815186,1702242067,330,789,0,0,333,2124,2913
SET4/102-45-3-3,2393444862,1702242073,314,618,0,0,314,1710,2328
SET4/102-45-3-3,2955110160,1702242078,321,646,0,0,321,2704,3350
SET4/102-45-3-3,231762777,1702242083,405,917,0,0,407,3231,4148
SET4/102-45-3-3,2605158757,1702242090,409,929,0,0,419,3781,4710
SET4/102-45-3-3,1252686376,1702242097,324,623,0,0,324,1702,2325
SET4/102-45-3-3,1807316231,1702242102,243,553,0,0,243,1057,1610
SET4/102-45-3-3,1640925389,1702242106,313,620,0,0,324,2198,2818
SET4/102-45-3-3,2680139757,1702242112,407,935,0,0,429,2986,3921
SET4/102-45-3-3,538210758,1702242118,251,549,0,0,251,1002,1551
